GGGGGGGGGGGGGGGGGGGGGGGGGGGGOOOO
GGGFFFGGGGGMFFFGFFFFFGGGGGGGGOO
GGGFFGGGGGMMMMFFFFGFGGGGGGGGOOO
GGGGGGGGGMMMMMMMMFFFGGGGGGGGGGO
GGGGGGGGGGMMMMMFFFFGGGGGGGGGOO
GGGGGGGGGGMFFFFFFGGGGGGGGGGGGOO
GGGGGGFGGGGGFFFFGGGGGGGGGGGGOOO
GGGGGFFFGGGGGGGGLLLGGGGGGGGGGOO
GGGGFFGGGGGGGGLLLGGGGGGGGGOOOO
GGGGGGGGGGGGGGGGGLGGGGGGGGGGGOO
GGGGGUGGGGGGGGFFGGFGGGGGGGGGGOO
GGGGUUUGGGGGFFFFFFFFFGGGGGGGOO
GGGGGUGGGGGGGFFFFFFFFFGGGGGGGOO
GGGGGGGGGGGGGFFOOOOOFGGGGGGGOO
GGGGGGGGGGGGFFOOOOOOOFGGGGGGGOO